28 31
1 26 26 26 26 26 26 26 26 26 26 26 26 31 32 26 26 26 26 26 26 26 26 26 26 26 26 2 
18 40 40 40 40 40 40 40 40 40 40 40 40 3 11 40 40 40 40 40 40 40 40 40 40 40 40 25 
18 40 5 12 12 6 40 5 12 12 12 6 40 3 11 40 5 12 12 12 6 40 5 12 12 6 40 25 
18 40 3 40 40 11 40 3 40 40 40 11 40 3 11 40 3 40 40 40 11 40 3 40 40 11 40 25 
18 40 13 4 4 14 40 13 4 4 4 14 40 13 14 40 13 4 4 4 14 40 13 4 4 14 40 25 
18 40 40 40 40 40 40 40 40 40 40 40 40 40 40 40 40 40 40 40 40 40 40 40 40 40 40 25 
18 40 5 12 12 6 40 5 6 40 5 12 12 12 12 12 12 6 40 5 6 40 5 12 12 6 40 25 
18 40 13 4 4 14 40 3 11 40 13 4 4 7 8 4 4 14 40 3 11 40 13 4 4 14 40 25 
18 40 40 40 40 40 40 3 11 40 40 40 40 3 11 40 40 40 40 3 11 40 40 40 40 40 40 25 
9 17 17 17 17 6 40 3 16 12 12 6 40 3 11 40 5 12 12 15 11 40 5 17 17 17 17 10 
40 40 40 40 40 18 40 3 8 4 4 14 40 13 14 40 13 4 4 7 11 40 25 40 40 40 40 40 
40 40 40 40 40 18 40 3 11 40 40 40 40 40 40 40 40 40 40 3 11 40 25 40 40 40 40 40 
40 40 40 40 40 18 40 3 11 40 19 17 33 34 34 35 17 20 40 3 11 40 25 40 40 40 40 40 
26 26 26 26 26 14 40 13 14 40 25 40 40 40 40 40 40 18 40 13 14 40 13 26 26 26 26 26 
40 40 40 40 40 40 40 40 40 40 25 40 40 40 40 40 40 18 40 40 40 40 40 40 40 40 40 40 
17 17 17 17 17 6 40 5 6 40 25 40 40 40 40 40 40 18 40 5 6 40 5 17 17 17 17 17 
40 40 40 40 40 18 40 3 11 40 27 26 26 26 26 26 26 28 40 3 11 40 25 40 40 40 40 40 
40 40 40 40 40 18 40 3 11 40 40 40 40 40 40 40 40 40 40 3 11 40 25 40 40 40 40 40 
40 40 40 40 40 18 40 3 11 40 5 12 12 12 12 12 12 6 40 3 11 40 25 40 40 40 40 40 
1 26 26 26 26 14 40 13 14 40 13 4 4 7 8 4 4 14 40 13 14 40 13 26 26 26 26 2 
18 40 40 40 40 40 40 40 40 40 40 40 40 3 11 40 40 40 40 40 40 40 40 40 40 40 40 25 
18 40 5 12 12 6 40 5 12 12 12 6 40 3 11 40 5 12 12 12 6 40 5 12 12 6 40 25 
18 40 13 4 7 11 40 13 4 4 4 14 40 13 14 40 13 4 4 4 14 40 3 8 4 14 40 25 
18 40 40 40 3 11 40 40 40 40 40 40 40 40 40 40 40 40 40 40 40 40 3 11 40 40 40 25 
22 12 6 40 3 11 40 5 6 40 5 12 12 12 12 12 12 6 40 5 6 40 3 11 40 5 12 21 
30 4 14 40 13 14 40 3 11 40 13 4 4 7 8 4 4 14 40 3 11 40 13 14 40 13 4 29 
18 40 40 40 40 40 40 3 11 40 40 40 40 3 11 40 40 40 40 3 11 40 40 40 40 40 40 25 
18 40 5 12 12 12 12 15 16 12 12 6 40 3 11 40 5 12 12 15 16 12 12 12 12 6 40 25 
18 40 13 4 4 4 4 4 4 4 4 14 40 13 14 40 13 4 4 4 4 4 4 4 4 14 40 25 
18 40 40 40 40 40 40 40 40 40 40 40 40 40 40 40 40 40 40 40 40 40 40 40 40 40 40 25 
9 17 17 17 17 17 17 17 17 17 17 17 17 17 17 17 17 17 17 17 17 17 17 17 17 17 17 10