000000000
011111110
010010010
010010010
011111110
010010010
010010010
011111110
000000000
